R 750 640

NO ./maps/pics/yossi.png
WE ./maps/pics/wood.png
S ./maps/pics/barrel.png
EA ./maps/pics/bluestone.png

C 15,15,15
F 100,100,100

111111111111111111111111111111111111111111111111111111111111
100000000000000000000000000000000000000000000000000000000001
100000000000000000000010000000000000000011100000000000000001
100000000000000000000000000001000000000000000000000000000001
100000000000000000000000000001000000001111100000000000000001
100001111000000000000000000001000000000000000000000000000001
100000000000000000000000000111000000000000000000000000000001
100000000000000000000000000001111111111100000000000000000001
100000000000000000000000000000000000000101110000000000000001
100000000000000000000000000000000000000100010000000000000001
100000000000000000000000000000000000000100010000000000000001
100000000000000000000000000000000000000100010000000000000001
100000000000000000000000000000000000000100010000000000000001
100000000000000000000000000000000000000100010000000000000001
100000000000000000000000000000000000000100010000000000000001
100000000000000000000000000000000111111100110000000000000001
100000000000000000000000000000000000000000100000000000000001
100000000000000000000000000000000011110000100000000000000001
100000000000000000000000000N00000000000000100000000000000001
100000000000000011111111111111111111000000100000000000000001
100000000000000000000000000000000000000000100000000000000001
100000000000000011111111111111111111111111100000000000000001
100000000000000000000000000000000000000000000000000000000001
100000000000000000100000000000000000000000000000000000000001
100000000000000000100000011111000001111111100000000000000001
100000000000000000100000000000000000000000000000000000000001
100000000000000000100000000000000000000000000000000000000001
100000000000000000100000111111111111111111111110000000000001
100000000000000000100000000000000000000000000000000000000001
100000000000000000100000000000000000000000000000000000000001
100000000000000000100011111111111111111111111110000000000001
100000000000000000000000000000000000000000000000000000000001
100000000000000000000000011111111111100000000000000000000001
100000000000000000000000000000011111100000000000000000000001
100000000000000000000000000000000000000000000000000000000001
100000000000000000000000000000000000000000000000000000000001
100000000000000111000000000000000000000000000000000000000001
100000000000000000000000000000000000000000000000000000000001
100000000000000000000000000000000000000000000000000000000001
111111111111111111111111111111111111111111111111111111111111
