NO ./maps/pics/arbre.png
SO ./maps/pics/colorstone.png
WE ./maps/pics/yocapell.png
EA ./maps/pics/eagle.png
S ./maps/pics/barrel.png
C 173,216,230
F 100,100,100

R 560 480

111111111111111111111111111111111111111111111111111111111111111111111111111111111111111111111111111111111111111111111111111111111111111
100000100001111111100000000000000000000000000000000000000000000000000000000000000000000000000000000000001100000000000000000000000001001
100000100001111111100000000000000000000000000000000000000000000000000000000000000000000000000000000000001100000000000000000000000001001
100N00000001111111100111111111111001111111111001110011111111111110010011111111111111111111111111111111111100111111111111111111111001001
100000100001111111100111111111111001111100111001110011111111111110010000000000000000000000000000000000000000111111111111111111111001001
100000100001111111100111111111111001111100111000000000000000000000000010000000000000000000000000000000000000100000000000000000000001001
110011100110000000000000000000000001111100111000000000000000000000000010000000000000000000000000000000000000100000000000000000000001001
110000000000000000000000000000000001000000000001001001111111111111110000111111111111111111111100111111111100110011001001111111111001001
100000000000111111111001001001001001000000000001001001111111111111110000111111111111111111111100111111111100110011001001111111111001001
111111111100111111111001111111111001111111111001001001100000000000000000000000000000000000000000010000000000110011001001111111111001001
111111111100111111111001111111111001111111111001001001100000000000000000000000000000000000000000010000000000110011001001111111111001001
111111100000000000000000000000000001111111111001001001111111111111111110001111111111111111111110010000000000000011001001000000000000001
111100000111111111111111111100100000000000000000000000000000000000000000001111111111100000000000010000000000000011001001000000000000001
111100000110000000000000000000100000000000000000000000000000000000000000001111111111100000000000010000000000000000000000000000000000001
111111100110000000000000000000100100111111111111111111111111111111111111111111111111111111111110010000000000000000000000000000000000001
111111100110000000000000000000100100000000000000000000000000000000000000000000000000000000000000010000111111111111111110011111111111001
111111100111111111111111111100000100000000000000000000000000000000000000000000000000000000000000010000111111111000000000011111111111001
111111100000000000000000000100000100111111111111111111111111111111111111111111111111111111111110010000111111111000000000011111111111001
111111100000000000000000000100000100111111111111111111111111111110000000000000000000111111111110000100000000000001111110011111111111001
111110011100111111111111100100000100111111111111111111111111111110000000000000000000111111111111100100000000000001111110011111111111001
111110011100111111111111100100000100111111111111111111111111111111100111111111110011111111111110000000111111111001111110011111111111001
111110011100111111111111100100000100111111111111111111111111111111100111111111110011111111111110000000111111111001111110000000000000001
111110011100111111111111100000000000111111111111111111111000000000000000000001110011111111111110010000111111111001111110000000000000001
111110011100111111111111110000000001111111111111111111111000000000000000000001110011111111111110010000111111111001111110011111111111001
111110011100111111111111111000000011111111111111111111111000000000000000000001110011111111111110010000111111111001111110011111111111001
111110011100111111111111111100000111111111111111111111111000000000220000000001110011111111111110010000111111111001111110011111111111001
111110011100111111111111111110001111111111111111111111111000000000220000000001110011111111111110010000111111111001111110011111111111001
111110011100111111111111111111011111111111111111111111111000000000000000000001110011111111111110010000111111111001111110011111111111001
111110011100111111111111111111011111111111111111111111111000000000000000000001110011111111111110010000111111111001111110011111111111001
111110011100111111111111111111011111111111111111111111111000000000000000000001110011111111111110010011111111111001111110011111111111001
111110011100000000000000000000000000000000000000000000000111111111111111111111110000000000000000000010000000000000000000000000000000001
111110011100000000000000000000000000000000000000000000000111111111111111111111110000000000000000000010000000000000000000000000000000001
111110000111111100111111111111111111111111111111111111100100000000000000000000010011111111111111001110011111111111111111111001111111001
111110000111111100111111111111111111111111111111111111100100000000000000000000010011111111111111001110011111111111111111111001111111001
111111100111111100111111111111000000000000000000000000000111111111001111111110010011111111111111001110011111111111111111111001111111001
111111100111111100111111111111000000000000000000000000000111111111001111111110010011111111111111001110011111111111111111111001111111001
111111100111111100111111111111001111110011111111111111100111111111001111111110010011111111111111001110000000000000000000000001111111001
111111100111111100111111111111001111110011111111111111100111111111001100000000000001111111111111001110000000000000000000000001111111001
111111100111111100111111111111001111110000000111111111100000000000001100000000000001111111111111001110011111111111111111111001111111001
111111100111111100111111111111001111110000000111111111100000000000001100000000000001111111111111001110011111111111111111111001111111001
111111100111111100111111111111001111111111111111111111100000000000001100000000000001111111111111001110011111111111111111111001111111001
111111100111111100111111111111001111111111111111111111100000000000001100000000000001111111111111001110011111111111111111111001111111001
100000000000000000111111111111000000000000000000000000000000000000001100000000000001111111111111001110011111111111111111111001111111001
100000000000000000111111111111000000000000000000000000000000000000000000111111111111000000000000000000011000000000000000000000001111001
111111100111111100111111111111111111111100111111111111100000000000000000111111111111000000000000000000011000000000000000000000001111001
111111100111111100111111111111111111111100111111110011111111111111111100111111111111001111111111111100011111111111111100111111111111111
111111100111111100111111111111111111111100111111110011111111111111111100111111111111001111111111111100011111111111111100111111111111111
100000000000000000000000000000000000000000111111110000000000000000000000111111111111001111111111111100011111111111111100111111111111111
100000000000000000000000000000000000000000111111110000000000000000000000111111111111001111111111111100011111111111111100111111111111111
111111111111111111111111111111111111111111111111111111111111111111111100111111111111001111111111111100011111111111111100111111111111111
111111111111111111111111111111111111111111111111111111111111111111111111111111111111111111111111111111111111111111111111111111111111111
